"","Chromosome","OverlapRange","OverlapSequence","TotalSplits","TotalSplits_VirusCenter","RightSplits","LeftSplits","TotalConcordantSplits","TotalConcordantSplits_VirusCenter","TotalConcordantSenseVirusSplits","TotalConcordantAntisenseVirusSplits","RightConcordantSplits","LeftConcordantSplits","filename","sample_id","group","mutation_type","startOverlap","endOverlap"
"1",1,"806165-806169","CCGAG",211,0,211,0,106,0,47,59,106,0,"Lys2_ev_pop1_1_L001_vsHostVirus_BWA-mem.sortfilter_hostSplits_Overlaps.tsv","Lys2_ev_pop1_1","ev_pop_1","spacer_deletion",806165,806169
"2",1,"826108-826112","AGCAG",242,0,0,242,111,0,0,111,0,111,"Lys2_ev_pop1_1_L001_vsHostVirus_BWA-mem.sortfilter_hostSplits_Overlaps.tsv","Lys2_ev_pop1_1","ev_pop_1","spacer_deletion",826108,826112
"3",1,"806165-806169","CCGAG",73,0,73,0,34,0,18,16,34,0,"Lys2_ev_pop1_2_L001_vsHostVirus_BWA-mem.sortfilter_hostSplits_Overlaps.tsv","Lys2_ev_pop1_2","ev_pop_1","spacer_deletion",806165,806169
"4",1,"826108-826112","AGCAG",71,0,0,71,33,0,0,33,0,33,"Lys2_ev_pop1_2_L001_vsHostVirus_BWA-mem.sortfilter_hostSplits_Overlaps.tsv","Lys2_ev_pop1_2","ev_pop_1","spacer_deletion",826108,826112
"5",1,"2835108-2835112","CAGGA",164,0,164,0,85,0,40,45,85,0,"Lys2_ev_pop1_3_L001_vsHostVirus_BWA-mem.sortfilter_hostSplits_Overlaps.tsv","Lys2_ev_pop1_3","ev_pop_1","large_deletion",2835108,2835112
"6",1,"3078848-3078852","GTCAT",160,0,0,160,79,0,0,79,0,79,"Lys2_ev_pop1_3_L001_vsHostVirus_BWA-mem.sortfilter_hostSplits_Overlaps.tsv","Lys2_ev_pop1_3","ev_pop_1","large_deletion",3078848,3078852
"7",1,"806165-806169","CCGAG",214,0,214,0,93,0,49,44,93,0,"Lys2_ev_pop1_3_L001_vsHostVirus_BWA-mem.sortfilter_hostSplits_Overlaps.tsv","Lys2_ev_pop1_3","ev_pop_1","large_deletion",806165,806169
"8",1,"826108-826112","AGCAG",211,0,0,211,95,0,0,95,0,95,"Lys2_ev_pop1_3_L001_vsHostVirus_BWA-mem.sortfilter_hostSplits_Overlaps.tsv","Lys2_ev_pop1_3","ev_pop_1","large_deletion",826108,826112
"9",1,"1120309-1120313","ATCCG",162,0,0,162,83,0,83,0,0,83,"Lys2_ev_pop1_4_L001_vsHostVirus_BWA-mem.sortfilter_hostSplits_Overlaps.tsv","Lys2_ev_pop1_4","ev_pop_1","large_deletion",1120309,1120313
"10",1,"1148078-1148082","ACCTG",162,0,162,0,77,0,35,42,77,0,"Lys2_ev_pop1_4_L001_vsHostVirus_BWA-mem.sortfilter_hostSplits_Overlaps.tsv","Lys2_ev_pop1_4","ev_pop_1","large_deletion",1148078,1148082
"11",1,"2839223-2839227","GATGG",120,0,120,0,55,0,35,20,55,0,"Lys2_ev_pop1_4_L001_vsHostVirus_BWA-mem.sortfilter_hostSplits_Overlaps.tsv","Lys2_ev_pop1_4","ev_pop_1","large_deletion",2839223,2839227
"12",1,"3026092-3026096","CCGGC",157,0,0,157,82,0,0,82,0,82,"Lys2_ev_pop1_4_L001_vsHostVirus_BWA-mem.sortfilter_hostSplits_Overlaps.tsv","Lys2_ev_pop1_4","ev_pop_1","large_deletion",3026092,3026096
"13",1,"806165-806169","CCGAG",170,0,170,0,79,0,33,46,79,0,"Lys2_ev_pop1_4_L001_vsHostVirus_BWA-mem.sortfilter_hostSplits_Overlaps.tsv","Lys2_ev_pop1_4","ev_pop_1","large_deletion",806165,806169
"14",1,"826108-826112","AGCAG",180,0,0,180,86,0,0,86,0,86,"Lys2_ev_pop1_4_L001_vsHostVirus_BWA-mem.sortfilter_hostSplits_Overlaps.tsv","Lys2_ev_pop1_4","ev_pop_1","large_deletion",826108,826112
"15",1,"806165-806169","CCGAG",245,0,245,0,114,0,58,56,114,0,"Lys2_ev_pop1_5_L001_vsHostVirus_BWA-mem.sortfilter_hostSplits_Overlaps.tsv","Lys2_ev_pop1_5","ev_pop_1","spacer_mutation",806165,806169
"16",1,"826108-826112","AGCAG",241,0,0,241,120,0,0,120,0,120,"Lys2_ev_pop1_5_L001_vsHostVirus_BWA-mem.sortfilter_hostSplits_Overlaps.tsv","Lys2_ev_pop1_5","ev_pop_1","spacer_mutation",826108,826112
"17",1,"806165-806169","CCGAG",285,0,285,0,152,0,72,80,152,0,"Lys2_ev_pop1_6_L001_vsHostVirus_BWA-mem.sortfilter_hostSplits_Overlaps.tsv","Lys2_ev_pop1_6","ev_pop_1","spacer_mutation",806165,806169
"18",1,"826108-826112","AGCAG",276,0,0,276,143,0,0,143,0,143,"Lys2_ev_pop1_6_L001_vsHostVirus_BWA-mem.sortfilter_hostSplits_Overlaps.tsv","Lys2_ev_pop1_6","ev_pop_1","spacer_mutation",826108,826112
"19",1,"2921856-2921860","CTACC",230,0,230,0,116,0,59,57,116,0,"Lys2_ev_pop2_1_L001_vsHostVirus_BWA-mem.sortfilter_hostSplits_Overlaps.tsv","Lys2_ev_pop2_1","ev_pop_2","large_deletion",2921856,2921860
"20",1,"3009983-3009987","ATCGT",222,0,0,222,117,0,0,117,0,117,"Lys2_ev_pop2_1_L001_vsHostVirus_BWA-mem.sortfilter_hostSplits_Overlaps.tsv","Lys2_ev_pop2_1","ev_pop_2","large_deletion",3009983,3009987
"21",1,"806165-806169","CCGAG",324,0,324,0,163,0,60,103,163,0,"Lys2_ev_pop2_1_L001_vsHostVirus_BWA-mem.sortfilter_hostSplits_Overlaps.tsv","Lys2_ev_pop2_1","ev_pop_2","large_deletion",806165,806169
"22",1,"826108-826112","AGCAG",281,0,0,281,136,0,0,136,0,136,"Lys2_ev_pop2_1_L001_vsHostVirus_BWA-mem.sortfilter_hostSplits_Overlaps.tsv","Lys2_ev_pop2_1","ev_pop_2","large_deletion",826108,826112
"23",1,"806165-806169","CCGAG",386,0,386,0,186,0,81,105,186,0,"Lys2_ev_pop2_2_L001_vsHostVirus_BWA-mem.sortfilter_hostSplits_Overlaps.tsv","Lys2_ev_pop2_2","ev_pop_2","cas_mutation",806165,806169
"24",1,"826108-826112","AGCAG",399,0,0,399,205,0,0,205,0,205,"Lys2_ev_pop2_2_L001_vsHostVirus_BWA-mem.sortfilter_hostSplits_Overlaps.tsv","Lys2_ev_pop2_2","ev_pop_2","cas_mutation",826108,826112
"25",1,"2890187-2890191","GATTC",89,0,89,0,59,0,34,25,59,0,"Lys2_ev_pop2_3_L001_vsHostVirus_BWA-mem.sortfilter_hostSplits_Overlaps.tsv","Lys2_ev_pop2_3","ev_pop_2","large_deletion",2890187,2890191
"26",1,"3084702-3084706","CACCT",59,0,0,59,34,0,0,34,0,34,"Lys2_ev_pop2_3_L001_vsHostVirus_BWA-mem.sortfilter_hostSplits_Overlaps.tsv","Lys2_ev_pop2_3","ev_pop_2","large_deletion",3084702,3084706
"27",1,"6222744-6222748","TCACC",118,0,0,118,64,0,64,0,0,64,"Lys2_ev_pop2_3_L001_vsHostVirus_BWA-mem.sortfilter_hostSplits_Overlaps.tsv","Lys2_ev_pop2_3","ev_pop_2","large_deletion",6222744,6222748
"28",1,"6410645-6410649","ATATC",113,0,113,0,57,0,29,28,57,0,"Lys2_ev_pop2_3_L001_vsHostVirus_BWA-mem.sortfilter_hostSplits_Overlaps.tsv","Lys2_ev_pop2_3","ev_pop_2","large_deletion",6410645,6410649
"29",1,"806165-806169","CCGAG",118,0,118,0,53,0,25,28,53,0,"Lys2_ev_pop2_3_L001_vsHostVirus_BWA-mem.sortfilter_hostSplits_Overlaps.tsv","Lys2_ev_pop2_3","ev_pop_2","large_deletion",806165,806169
"30",1,"826108-826112","AGCAG",128,0,0,128,60,0,0,60,0,60,"Lys2_ev_pop2_3_L001_vsHostVirus_BWA-mem.sortfilter_hostSplits_Overlaps.tsv","Lys2_ev_pop2_3","ev_pop_2","large_deletion",826108,826112
"31",1,"806165-806169","CCGAG",252,0,252,0,133,0,62,71,133,0,"Lys2_ev_pop2_4_L001_vsHostVirus_BWA-mem.sortfilter_hostSplits_Overlaps.tsv","Lys2_ev_pop2_4","ev_pop_2","spacer_deletion",806165,806169
"32",1,"826108-826112","AGCAG",231,0,0,231,122,0,0,122,0,122,"Lys2_ev_pop2_4_L001_vsHostVirus_BWA-mem.sortfilter_hostSplits_Overlaps.tsv","Lys2_ev_pop2_4","ev_pop_2","spacer_deletion",826108,826112
"33",1,"806165-806169","CCGAG",265,0,265,0,136,0,59,77,136,0,"Lys2_ev_pop2_5_L001_vsHostVirus_BWA-mem.sortfilter_hostSplits_Overlaps.tsv","Lys2_ev_pop2_5","ev_pop_2","spacer_mutation",806165,806169
"34",1,"826108-826112","AGCAG",250,0,0,250,115,0,0,115,0,115,"Lys2_ev_pop2_5_L001_vsHostVirus_BWA-mem.sortfilter_hostSplits_Overlaps.tsv","Lys2_ev_pop2_5","ev_pop_2","spacer_mutation",826108,826112
"35",1,"1120303-1120307","GGCGT",181,0,181,0,94,0,37,57,94,0,"Lys2_ev_pop2_6_L001_vsHostVirus_BWA-mem.sortfilter_hostSplits_Overlaps.tsv","Lys2_ev_pop2_6","ev_pop_2","large_deletion",1120303,1120307
"36",1,"2811038-2811042","GCGAG",201,0,201,0,119,0,58,61,119,0,"Lys2_ev_pop2_6_L001_vsHostVirus_BWA-mem.sortfilter_hostSplits_Overlaps.tsv","Lys2_ev_pop2_6","ev_pop_2","large_deletion",2811038,2811042
"37",1,"3146373-3146377","AAGGC",135,0,0,135,80,0,0,80,0,80,"Lys2_ev_pop2_6_L001_vsHostVirus_BWA-mem.sortfilter_hostSplits_Overlaps.tsv","Lys2_ev_pop2_6","ev_pop_2","large_deletion",3146373,3146377
"38",1,"3146375-3146379","GGCGC",9,0,0,9,5,0,0,5,0,5,"Lys2_ev_pop2_6_L001_vsHostVirus_BWA-mem.sortfilter_hostSplits_Overlaps.tsv","Lys2_ev_pop2_6","ev_pop_2","large_deletion",3146375,3146379
"39",1,"806165-806169","CCGAG",223,0,223,0,113,0,46,67,113,0,"Lys2_ev_pop2_6_L001_vsHostVirus_BWA-mem.sortfilter_hostSplits_Overlaps.tsv","Lys2_ev_pop2_6","ev_pop_2","large_deletion",806165,806169
"40",1,"826108-826112","AGCAG",234,0,0,234,113,0,0,113,0,113,"Lys2_ev_pop2_6_L001_vsHostVirus_BWA-mem.sortfilter_hostSplits_Overlaps.tsv","Lys2_ev_pop2_6","ev_pop_2","large_deletion",826108,826112
"41",1,"826109-826113","GCAGG",6,0,0,6,1,0,0,1,0,1,"Lys2_ev_pop2_6_L001_vsHostVirus_BWA-mem.sortfilter_hostSplits_Overlaps.tsv","Lys2_ev_pop2_6","ev_pop_2","large_deletion",826109,826113
"42",1,"876284-876288","ACTGG",185,0,0,185,95,0,0,95,0,95,"Lys2_ev_pop2_6_L001_vsHostVirus_BWA-mem.sortfilter_hostSplits_Overlaps.tsv","Lys2_ev_pop2_6","ev_pop_2","large_deletion",876284,876288
"43",1,"806165-806169","CCGAG",152,0,152,0,76,0,34,42,76,0,"Lys2_ev_pop3_1_L001_vsHostVirus_BWA-mem.sortfilter_hostSplits_Overlaps.tsv","Lys2_ev_pop3_1","ev_pop_3","cas_mutation",806165,806169
"44",1,"826108-826112","AGCAG",155,0,0,155,69,0,0,69,0,69,"Lys2_ev_pop3_1_L001_vsHostVirus_BWA-mem.sortfilter_hostSplits_Overlaps.tsv","Lys2_ev_pop3_1","ev_pop_3","cas_mutation",826108,826112
"45",1,"806165-806169","CCGAG",297,0,297,0,152,0,71,81,152,0,"Lys2_ev_pop3_2_L001_vsHostVirus_BWA-mem.sortfilter_hostSplits_Overlaps.tsv","Lys2_ev_pop3_2","ev_pop_3","spacer_deletion",806165,806169
"46",1,"826108-826112","AGCAG",276,0,0,276,130,0,0,130,0,130,"Lys2_ev_pop3_2_L001_vsHostVirus_BWA-mem.sortfilter_hostSplits_Overlaps.tsv","Lys2_ev_pop3_2","ev_pop_3","spacer_deletion",826108,826112
"47",1,"806165-806169","CCGAG",294,0,294,0,162,0,79,83,162,0,"Lys2_ev_pop3_3_L001_vsHostVirus_BWA-mem.sortfilter_hostSplits_Overlaps.tsv","Lys2_ev_pop3_3","ev_pop_3","cas_mutation",806165,806169
"48",1,"826108-826112","AGCAG",304,0,0,304,141,0,0,141,0,141,"Lys2_ev_pop3_3_L001_vsHostVirus_BWA-mem.sortfilter_hostSplits_Overlaps.tsv","Lys2_ev_pop3_3","ev_pop_3","cas_mutation",826108,826112
"49",1,"2934003-2934007","AGGCT",207,0,207,0,102,0,36,66,102,0,"Lys2_ev_pop3_4_L001_vsHostVirus_BWA-mem.sortfilter_hostSplits_Overlaps.tsv","Lys2_ev_pop3_4","ev_pop_3","large_deletion",2934003,2934007
"50",1,"2994541-2994545","ACCTT",191,0,0,191,71,0,0,71,0,71,"Lys2_ev_pop3_4_L001_vsHostVirus_BWA-mem.sortfilter_hostSplits_Overlaps.tsv","Lys2_ev_pop3_4","ev_pop_3","large_deletion",2994541,2994545
"51",1,"806165-806169","CCGAG",291,0,291,0,137,0,61,76,137,0,"Lys2_ev_pop3_4_L001_vsHostVirus_BWA-mem.sortfilter_hostSplits_Overlaps.tsv","Lys2_ev_pop3_4","ev_pop_3","large_deletion",806165,806169
"52",1,"826108-826112","AGCAG",312,0,0,312,141,0,0,141,0,141,"Lys2_ev_pop3_4_L001_vsHostVirus_BWA-mem.sortfilter_hostSplits_Overlaps.tsv","Lys2_ev_pop3_4","ev_pop_3","large_deletion",826108,826112
"53",1,"2903545-2903549","CTTGT",360,0,360,0,185,0,78,107,185,0,"Lys2_ev_pop3_5_L001_vsHostVirus_BWA-mem.sortfilter_hostSplits_Overlaps.tsv","Lys2_ev_pop3_5","ev_pop_3","large_deletion",2903545,2903549
"54",1,"2937793-2937797","CGGAT",6,0,0,6,1,0,0,1,0,1,"Lys2_ev_pop3_5_L001_vsHostVirus_BWA-mem.sortfilter_hostSplits_Overlaps.tsv","Lys2_ev_pop3_5","ev_pop_3","large_deletion",2937793,2937797
"55",1,"2937794-2937798","GGATA",228,0,0,228,113,0,0,113,0,113,"Lys2_ev_pop3_5_L001_vsHostVirus_BWA-mem.sortfilter_hostSplits_Overlaps.tsv","Lys2_ev_pop3_5","ev_pop_3","large_deletion",2937794,2937798
"56",1,"806165-806169","CCGAG",402,0,402,0,180,0,85,95,180,0,"Lys2_ev_pop3_5_L001_vsHostVirus_BWA-mem.sortfilter_hostSplits_Overlaps.tsv","Lys2_ev_pop3_5","ev_pop_3","large_deletion",806165,806169
"57",1,"826108-826112","AGCAG",378,0,0,378,205,0,0,205,0,205,"Lys2_ev_pop3_5_L001_vsHostVirus_BWA-mem.sortfilter_hostSplits_Overlaps.tsv","Lys2_ev_pop3_5","ev_pop_3","large_deletion",826108,826112
"58",1,"806165-806169","CCGAG",211,0,211,0,111,0,44,67,111,0,"Lys2_ev_pop3_6_L001_vsHostVirus_BWA-mem.sortfilter_hostSplits_Overlaps.tsv","Lys2_ev_pop3_6","ev_pop_3","cas_deletion",806165,806169
"59",1,"826108-826112","AGCAG",221,0,0,221,112,0,0,112,0,112,"Lys2_ev_pop3_6_L001_vsHostVirus_BWA-mem.sortfilter_hostSplits_Overlaps.tsv","Lys2_ev_pop3_6","ev_pop_3","cas_deletion",826108,826112
